What colour is the egg? It is yellow. - Akej farby je vajicko? Je zlte. (egg - vajicko)
What colour is the egg? It is blue. - Akej farby je vajicko? Je modre.
What colour is the egg? It is red. - Akej farby je vajicko? Je cervene.
What colour is the egg? It is pink. - Akej farby je vajicko? Je ruzove.

Which horse is eating? The grey horse is eating. - Ktory kon je? Sivy kon je.
Which is the black horse? - Ktory je cierny kon?
Which is the white horse? - Ktory je biely kon?
Which horse is the girl brushing? The brown horse. - Ktoreho kona dievca kefuje? Hnedeho kona.

a black and white dog - cierno-biely pes
a black and white cat - cierno-biela macka
a brown dog - hnedy pes
a brown and white cat - hneda a biela macka

a red T-shirt - cervene tricko
green grass and a green cap - zelena trava a zelena ciapka
yellow flowers - zlte kvety
a white building - biela budova

The horse is on yellow. - Kon je na zltom.
The horse is on purple. - Kon je na fialovej.
The horse is on blue. - Kon je na modrej.
The horse is on red. - Kon je na cervenej.

green grass - zelena trava
yellow and black - zlta a cierna
blue water - modra voda
orange and yellow - oranzova a zlta

pink flowers - ruzove kvety
two white and yellow flowers - dva bielo-zlte kvety
a yellow, a red and a pink flower - zlty, cerveny a ruzovy kvet
two red flowers - dva cervene kvety

seven - sedem
three - tri
nine - devat
four - styri

ten - desat
nine - devat
five balls - pat lopticiek
six balls - sest lopticiek

one ball - jedna lopticka
eight fingers - osem prstov
two balls - dve lopticky
five - pat

